GENOMEFOLDER=genome
REFGENOME=genome/Coccidioides_posadasii_Silveira.scaffolds.fa
GENOMENAME=CposSilveira
REPEATGFF=Coccidioides_posadasii_Silveira.scaffolds.repeat_masker.gff3
SAMPFILE=samples.csv
FASTQFOLDER=input
FASTQEXT=fastq.gz
UNMAPPED=unmapped
UNMAPPEDASM=unmapped_asm
ASMEXT=fasta
ALNFOLDER=aln
ALNTOOL=bwa
HTCFOLDER=cram
HTCEXT=cram
HTCFORMAT=cram
TEMP=/scratch
GVCFFOLDER=gvcf
TREEDIR=strain_tree
RGCENTER=NAU
RGPLATFORM=Illumina
GVCF_INTERVAL=1
FINALVCF=vcf
PREFIX=Cpos_1
REFNAME=Silveira-REF
BQSRALN=bsqr
SLICEVCF=vcf_slice
SNPEFFOUT=snpEff
snpEffConfig=snpEff.config
SNPEFFGENOME=Coccidioides_posadasii_Silveira
GFFGENOME=Coccidioides_posadasii_Silveira.gff3
